# Tiempo
ahora → nau
ya → aia
antes → ande
después → enter
ayer → andehen
mañana → enterehen
hoy → nauhen
entonces → urte
antes de ayer → pre-andehen
pasado mañana → pos-enterehen
anoche → anito
anteanoche → pre-anito
todavía → enoun
siempre → ertsai
aún → oun
ya no → nomais
jamás, nunca → nontsai
temprano → yonto
tarde → egente
luego → ogen, ogenter
pronto → ayen, ayenter
mientras → engeri, intem

# Lugar
aquí → ake, atan
ahí → aye, alan
allí → alie, alan
cerca → neare
lejos → fore
junto → xa
delante → daotan, aldaotan
detrás → betran, albetran
atrás → betran
adelante → daotan
alrededor → eriodo
enfrente → imfranto
encima → alair
debajo → alaur
fuera → fora
dentro → intro, inter
abajo → aur
arriba → air
a la derecha, hacia la derecha → aldereite
a la izquierda, hacia la izquierda → alzoraite
al lado de → ensero

# Modo
bien → bain
mal → heun
solo (adverbio) → nokpo
mejor → bainere
peor → heunere
el peor → heunodo
el mejor → bainodo
así → aze
despacio → lento
todavía → enaun, enoun
deprisa → rantio

# Cantidad
poco → piko, poco
mucho → naito
muy → naito, moi
bastante → bixa
todo → aldex
más → mais
menos → minos, menus
tan → asle, tan
tanto → tante
demasiado → posmoi
casi → aslon, circa
forma irónica de decir casi → quasi
medio → media
apenas → apare
así de → aze da
harto → rakoso
otra vez → aran, retai

# Afirmación
si → ai
también → aiete
cierto → zerto
claro → klaro
exacto → exaito
obvio → obeo
verdaderamente → zertente

# Duda
probablemente → probekoien
quizá → qiza
puede ser → ponsei

# Negación
no → non, no
nunca, jamás → nontsai
tampoco → nonete
negativamente → nekatikoien

# Interrogativo
cómo (pregunta) → com
cuando → conde
donde → donde
por qué → porqa, por qa
quien → qain
que → qa
cual → qual
cuanto → qanto
hasta → haita

# Relativo
como (comparación) → asle

# Otros
sin embargo → orne
por cierto → por zerto
además → ademais