bienvenido → bainarei
gracias → grazei
muchas gracias → naito grazei
de nada → non lanai
por lo que → soqe
lo que sea → oraben
por favor → porqarei, porfevo
además → ademais
tan → tan
cerrar sesión → evokai sesai
correo electrónico → elektrikono maila
dirección de correo → elektrikonio direktia
por cierto → por zerto
hacerrisas → gisette (persona que intenta hacer gracia de manera común pero solo es molesto)
además → ademais
amor patriótico → onterraloi
tan → tan
lluvia de ideas → ideait-mixa
san valentín → st. valentino, sainto valentino
acaso → nurne
cariño (referencia a persona amada) → karico
siquiera, ni siquiera → nonixa
claro (refiriendote a algo que es claro) → klaro (Ejemplo: ¡claro que si me importan!)
¡mira! → siet (Ejemplo: Mira, estoy haciendo un trabajo de ciencias)
no te metas → non entreiet
hacia arriba → airnara
hacia abajo → aurnara
hacia delante → daotanara
hacia atrás → dabetranara
hacia la derecha → dereitenara
hacia la izquierda → zoraitenara
quererte tanto a ti mismo hasta el punto de necesitar atención médica → ipsogirgirigarigarei (broma de april fools)
se fueron (relacionado a sentimientos o conceptos) → dexaire
palabra baúl → cubavorto
creo → belo
por ahora → en nau
tiempo libre → xiatempo, oziotempo, ociotempo
de hecho → enfacto