amarillo → mallea
azul → anil
bizco → quete
blanco → bianco, alura
bobo → keke
carnívoro → karnivoro
diestro → deiranno
estafador → lerrako, zoike
fructívoro → fructivoro
futuro → futura
herbívoro → herbivoro
idiota → hunko, fruka, estulta
insectívoro → insectivoro
intermitente → tika
marrón → marro, brunno, bronzo, itsoso
material de mala calidad → petringo 
morado → purpuro, purpur
naranja (color) → oranja
negro → nekro, tura
obseso → oclure
gordo → lubo
omnivoro → omnivoro
persona muy salida → libidette
retenido → ataino
rojo → roixo
rojo → roxo
rosa → rosa
vegano → vegano
vegetariano → vegetaro
verde → berde
vivo → vitoso
zurdo → zoranno